CompositeGraphics	KEYWORD3
CompositeColorOutput	KEYWORD3
Vector	KEYWORD3
Matrix	KEYWORD3
Mesh	KEYWORD3
Image	KEYWORD3
TriangleTree	KEYWORD3
Font	KEYWORD3
NTSC	KEYWORD1
PAL	KEYWORD1
XRES	KEYWORD1
YRES	KEYWORD1
pixelAspect	KEYWORD1
init	KEYWORD2
setTextColor	KEYWORD2
setFont	KEYWORD2
setCursor	KEYWORD2
print	KEYWORD2
begin	KEYWORD2
dotFast	KEYWORD2
dot	KEYWORD2
dotAdd	KEYWORD2
get	KEYWORD2
set	KEYWORD2
xLine	KEYWORD2
triangle	KEYWORD2
enqueueTriangle	KEYWORD2
line	KEYWORD2
flush	KEYWORD2
end	KEYWORD2
fillRect	KEYWORD2
rect	KEYWORD2
transform	KEYWORD2
identity	KEYWORD2
scaling	KEYWORD2
translation	KEYWORD2
rotation	KEYWORD2
perspective	KEYWORD2
draw	KEYWORD2
drawAdd	KEYWORD2
drawTriangles	KEYWORD2
drawEdges	KEYWORD2
drawVertices	KEYWORD2
drawChar	KEYWORD2
sendFrameHalfResolution	KEYWORD2
setHue	KEYWORD2
